1111111111111111111111111111111111
100000000000000C000000000001000001
100010000E00000010000C000000000001
1010010100100000001001000000010101
1010010100100000101001000000010101
1010010010101010001000000100010101
1010C100101010100010010000C0010101
1P0000000000C0001000000000000100C1
100001000C0000000000010000000000C1
1111111111111111111111111111111111