11111111111111111111111111111111111
1P0000000000000C0000000000000000001
10000000000000000000000000000000001
10000000011111100000000001111110001
10000000000000000000000000000000001
1000000000000000C000000000000000001
10001111100000000000011111000000001
10000000000000000000000000000000001
100000000000000000C0000000000000001
10000000000011111111110000000000001
100000C0000000000000000000000000001
11111111111100000000000000001111111
1C0000000000000000000000000000000E1
11111111111111111111111111111111111
